BANNER      | org.churuata.digital.entries.BannerEntryPoint      | Banner;
CONTACTS    | org.churuata.digital.entries.ContactsEntryPoint    | Edit Contact Details;
CREATE      | org.churuata.digital.entries.CreateEntryPoint      | Create a Churuata;
EDIT        | org.churuata.digital.entries.EditEntryPoint;       | Edit a Churuata;
EDIT_PROFILE| org.churuata.digital.entries.AccountEntryPoint     | Edit Profile;
LOGIN       | org.churuata.digital.entries.LoginEntryPoint       | Login;
LOGOFF      | org.churuata.digital.entries.LogoffEntryPoint      | Logoff;
MAP         | org.churuata.digital.entries.BasicEntryPoint       | Map;
ORGANISATION| org.churuata.digital.entries.OrganisationEntryPoint| Edit Organisation Details;
READY       | org.churuata.digital.entries.BasicEntryPoint       | Churuata;
REGISTER    | org.churuata.digital.entries.BasicEntryPoint       | Register a Service
GET_EMAIL   | org.churuata.digital.entries.BasicEntryPoint       | Get Email;

#Profile
ACCOUNT     | org.churuata.digital.entries.AccountEntryPoint     	| Edit Account;
ADDRESS     | org.churuata.digital.entries.AddressEntryPoint     	| Edit Address;
SERVICES    | org.churuata.digital.entries.ServicesEntryPoint    	| Edit Services;
SERVICE    	| org.churuata.digital.entries.ServiceEntryPoint    	| Edit Service;

# Add a Service
REGISTER         | org.churuata.digital.entries.register.RegisterEntryPoint       | Register a Service;
ADD_CONTACT      | org.churuata.digital.entries.register.AddContactEntryPoint     | Add a Contact;
ADD_ORGANISATION | org.churuata.digital.entries.register.AddOrganisationEntryPoint| Add an Organisation;
ADD_SERVICES     | org.churuata.digital.entries.AddServicesEntryPoint    		  | Add a Service;
LOCATION         | org.churuata.digital.entries.register.LocationEntryPoint       | Enter the Location;
SHOW_LEGAL       | org.churuata.digital.entries.register.ShowLegalEntryPoint      | Show Legal Disclaimer;
CONFIRM_SERVICE  | org.churuata.digital.entries.register.ConfirmServiceEntryPoint | Confirm the Service;

#Admin
ADMIN            | org.churuata.digital.entries.admin.AdminEntryPoint       | Administration;
EDIT_ADMIN       | org.churuata.digital.entries.admin.EditAdminEntryPoint   | Edit Administration;
USERS            | org.churuata.digital.entries.admin.UsersEntryPoint       | User Management;
ACCEPTANCE       | org.churuata.digital.entries.admin.AcceptanceEntryPoint  | Acceptance;